00010000101010
11010100100100
11110010101010
00001001001010
00000000101001
11111111000000
01010101010100